2.1
An Interactive Fiction by Reagan Simms
Release 1 / Serial number 180924 / Inform 7 build 6M62 (I6/v6.33 lib 6/12N) SD

Floor 4s of Nugent Hall
It is a long hallway. The walls are red, and the carpet isn't very soft. To the NORTH lies the Elevators to leave, to the EAST lies Reagan's Room. To the WEST lies a large lounge.

>EAST
Reagan's Room
A girl with blue hair is sprawled on her bed, cursing at her laptop. Her bookshelf is stacked high with linguistics textbooks, and a blue-and-black mobility scooter is parked in the corner. She looks irritated at being interrupted. Better leave, then.

There lies, right next to the bed, a locked navy blue trunk. A mug of tea and a box of cookies sits on the trunk.

On the locked oversized trunk are a mug of tea and a box of cookies (closed).

You can also see Mobility Scooter (on which is a basket (in which is an i-Card)) here.

>examine mobility scooter
The headlight is useless, the horn is pathetic, but you've gotta get around campus somehow.

>drive mobility scooter
That's not a verb I recognise.

* * *

2.1
An Interactive Fiction by Reagan Simms
Release 1 / Serial number 180924 / Inform 7 build 6M62 (I6/v6.33 lib 6/12N) SD

Floor 4s of Nugent Hall
It is a long hallway. The walls are red, and the carpet isn't very soft. To the NORTH lies the Elevators to leave, to the EAST lies Reagan's Room. To the WEST lies a large lounge.

>NORTH
Elevators
Ding! The Elevator's buttons make funny noises!

Shiny buttons, practically begging to be pressed.

>examine buttons
Why won't pressing these get you anywhere? How de-pressing.

>eat buttons
That's plainly inedible.

* * *

2.1
An Interactive Fiction by Reagan Simms
Release 1 / Serial number 180924 / Inform 7 build 6M62 (I6/v6.33 lib 6/12N) SD

Floor 4s of Nugent Hall
It is a long hallway. The walls are red, and the carpet isn't very soft. To the NORTH lies the Elevators to leave, to the EAST lies Reagan's Room. To the WEST lies a large lounge.

>e
Reagan's Room
A girl with blue hair is sprawled on her bed, cursing at her laptop. A a blue-and-black mobility scooter is parked in the corner. She looks irritated at being interrupted. Better leave, then.

The bookshelf sits off to the side in the room. On first glance, it seems nice enough. There's some leather bound books on the bottom shelf, and the rest of the shelves are filled with books from the library. It has been covered with marble contact paper, so it's a bit less plain. On top of it is a small glass with bamboo growing in it, and a succulent.

On the bookshelf are Bamboo, Succulent and a Song of Ice & Fire Books.

A wooden dresser, with a single open drawer, pushed against the wall.

>examine drawer
Inside the drawer is two boxes of cereal, four bags of popcorn, nine packages of ramen, and more tea than the entire British isles drink in a year.

In the Open Drawer are a package of ramen, a box of cereal and Popcorn.

* * *

2.1
An Interactive Fiction by Reagan Simms
Release 1 / Serial number 180924 / Inform 7 build 6M62 (I6/v6.33 lib 6/12N) SD

Floor 4s of Nugent Hall
It is a long hallway. The walls are red, and the carpet isn't very soft. To the NORTH lies the Elevators to leave, to the EAST lies Reagan's Room. To the WEST lies a large lounge.

>east
Reagan's Room
A girl with blue hair is sprawled on her bed, cursing at her laptop. A a blue-and-black mobility scooter is parked in the corner. She looks irritated at being interrupted. Better leave, then.

The bookshelf sits off to the side in the room. On first glance, it seems nice enough. There's some leather bound books on the bottom shelf, and the rest of the shelves are filled with books from the library. It has been covered with marble contact paper, so it's a bit less plain. On top of it is a small glass with bamboo growing in it, and a succulent.

On the bookshelf are Bamboo, Succulent and a Song of Ice & Fire Books.

A wooden dresser, with a single open drawer, pushed against the wall.

>e bookshelf
I only understood you as far as wanting to (go) e.

>examine bookshelf
On second glance you can tell that the contact paper is peeling off at the edges, and that the leather bound books are the Song of Ice and Fire series. The rest of the books are all non-fiction. The metal shelves are not bowing under the weight of so many books at least.

On the bookshelf are Bamboo, Succulent and a Song of Ice & Fire Books.

>examine dresser
In the Dresser is an Open Drawer.

>examine open drawer
Inside the drawer is two boxes of cereal, four bags of popcorn, nine packages of ramen, and more tea than the entire British isles drink in a year.

* * *

>examine bamboo
Its tall stalks fill you with tranquility.

* * *

>examine bookshelf
On second glance you can tell that the contact paper is peeling off at the edges, and that the leather bound books are the Song of Ice and Fire series. The rest of the books are all non-fiction. The metal shelves are not bowing under the weight of so many books at least.

On the bookshelf are Bamboo, Succulent and a Song of Ice \and Fire Books.

* * *

>examine locked oversized trunk
There's no possible way you could open the trunk, but there's plenty of things on top of it, like a mug of tea and a box of cookies.

On the locked oversized trunk are a mug of tea and a box of cookies (in which is a thumbprint cookie).

>eat tea
(first taking the mug of tea)
You eat the mug of tea. Not bad.

>drink tea
You can't see any such thing.

>drink cookie
There's nothing suitable to drink here.

>eat thumbprint cookie
(first taking the thumbprint cookie)
You eat the thumbprint cookie. Not bad.

* * *

>take i-Card
Taken.

>eat i-Card
That's plainly inedible.

* * *

2.1
An Interactive Fiction by Reagan Simms
Release 1 / Serial number 180924 / Inform 7 build 6M62 (I6/v6.33 lib 6/12N) SD

Floor 4s of Nugent Hall
It is a long hallway. The walls are red, and the carpet isn't very soft. To the NORTH lies the Elevators to leave, to the EAST lies Reagan's Room. To the WEST lies a large lounge.

>look
Kaya's Room
 You are tired and your bed looks so comfortable, but you have stuff to do... leave the room through the door to the WEST.

>west
Kitchen
 is big with wood floors and big windows. Outside the window there is a view of the mountains and a garden.  There's nothing in the fridge.. you should go to the store today. There is a door to the garden to the SOUTH, and a door to the living room to the SOUTHEAST.

>look
Kitchen
 There's nothing in the fridge.. you should go to the store today. There is a door to the garden to the SOUTH, and a door to the living room to the SOUTHEAST.

>east
Kaya's Room
 You are tired and your bed looks so comfortable, but you have stuff to do... leave the room through the door to the WEST.

>east
you are in the closet, there are shoes all over the floor and dresses falling off hangers, get out before you start cleaning!

* * *

2.1
An Interactive Fiction by Reagan Simms
Release 1 / Serial number 180924 / Inform 7 build 6M62 (I6/v6.33 lib 6/12N) SD

Floor 4s of Nugent Hall
It is a long hallway. The walls are red, and the carpet isn't very soft. To the NORTH lies the Elevators to leave, to the EAST lies Reagan's Room. To the WEST lies a large lounge.

>north
Elevators
Ding! The Elevator's buttons make funny noises!

Why won't pressing these get you anywhere? How de-pressing!

>examine buttons
You see nothing special about the buttons.

>look
Elevators
Ding! Ding! Ding! Fancy buttons! Too bad The Elevator isn't working.

 Shiny buttons, practically begging to be pressed.

>visit buttons
That's not a verb I recognise.

>touch buttons
You feel nothing unexpected.

>examine the buttons
You see nothing special about the buttons.

* * *

2.1
An Interactive Fiction by Reagan Simms
Release 1 / Serial number 180924 / Inform 7 build 6M62 (I6/v6.33 lib 6/12N) SD

Floor 4s of Nugent Hall
It is a long hallway. The walls are red, and the carpet isn't very soft. To the NORTH lies the Elevators to leave, to the EAST lies Reagan's Room. To the WEST lies a large lounge.

>west
Sorry, you can't simply walk into the walls. There is nothing really interesting over there! Instead, you can go NORTHWEST to Ikeberry Dining Hall or SOUTH to ARC building.

>east
Sorry, you can't simply walk into the walls. There is nothing really interesting over there! Instead, you can go NORTHWEST to Ikeberry Dining Hall or SOUTH to ARC building.

>northwest
Ikeberry Dining Hall
 Welcome to the Ikeberry Dining Hall! This place contains the largest dining hall on campus! In addition, there is the ikeberry library to study and there are some cafe shops like Caffinator and 57 North, were you can grab a quick bite and refuel yourself with coffee.

>south
Sorry, you simply can't walk into the deep frying oil. It's very dangourous! Instead, You can go NORTH towards Green Street or SOUTHEAST to Hopkins.

>east
Sorry, you simply can't walk into the deep frying oil. It's very dangourous! Instead, You can go NORTH towards Green Street or SOUTHEAST to Hopkins.

* * *

>west
Sorry, you can't simply walk into the walls. There is nothing really interesting over there! Instead, you can go NORTHWEST to Ikeberry Dining Hall or SOUTH to ARC building.

>west
Nathan & Cameron's Room
Going past the small foyer, lies a bookshelf filled with boardgames, a small fridge, and two TVs, side by side. Two beds are lofted in the room, and a futon sits under one of them. An Asian boy is playing Overwatch on the futon, while his roommate does his homework.

You can see a TV here.

>look
Nathan & Cameron's Room
Nathan and Cameron are fighting with swords again. Oh dear. Duck under a table or leave for your own safety.

You can see a TV here.

>turn off tv
You switch the TV off.

>west
There's nowhere else to go, unless you can travel through walls. Wait...Are you Danny Phantom?! No? Then, no, there's nowhere else to go.

>east
Large Lounge
Someone's snoring loudly. Nathan and Cameron's room door is open and to the WEST.

>east
Floor 4s of Nugent Hall
This floor is a lively place. You can hear someone crying hystetically in their room. Oh dear. Midterms are coming, after all. I wonder why the paint is missing from the wall in front of Reagan's Room to the EAST. Someone exists the Elevators to the NORTH, and heads to the large lounge in the WEST.

>east
Reagan's Room
A girl with blue hair is sprawled on her bed, cursing at her laptop. Her bookshelf is stacked high with linguistics textbooks, and a blue-and-black mobility scooter is parked in the corner. She looks irritated at being interrupted. Better leave, then.

There lies, right next to the bed, a locked navy blue trunk. A mug of tea and a box of cookies sits on the trunk.

On the locked oversized trunk are a mug of tea and a box of cookies (closed).

You can also see Mobility Scooter (on which is a basket (in which is an i-Card)) here.

>look at trunk
There's no possible way you could open the trunk, but there's plenty of things on top of it, like a mug of tea and a box of cookies.

On the locked oversized trunk are a mug of tea and a box of cookies (closed).

>take cookie
You can't see any such thing.

>open box of cookies
It isn't something you can open.

>take mug of tea
Taken.

>eat mug of tea
You eat the mug of tea. Not bad.

>take i-Card
Taken.

* * *

2.1
An Interactive Fiction by Reagan Simms
Release 1 / Serial number 180924 / Inform 7 build 6M62 (I6/v6.33 lib 6/12N) SD

Floor 4s of Nugent Hall
It is a long hallway. The walls are red, and the carpet isn't very soft. To the NORTH lies the Elevators to leave, to the EAST lies Reagan's Room. To the WEST lies a large lounge.

>wesy
That's not a verb I recognise.

>west
Large Lounge
Red and tan armchairs flank the giant windows, and a large couch is in front of a TV. People are studying, and a group of girls is talking far too loudly. Someone is napping in an armchair. To the WEST lies Nathan and Cameron's room.

>west
Nathan & Cameron's Room
Going past the small foyer, lies a bookshelf filled with boardgames, a small fridge, and two TVs, side by side. Two beds are lofted in the room, and a futon sits under one of them. An Asian boy is playing Overwatch on the futon, while his roommate does his homework.

You can see a TV here.

>tv
That's not a verb I recognise.

>look at tv
The large TV is currently light up with the popular video game Overwatch. How fun!

The TV is currently switched off.