2.2
An Interactive Fiction by Reagan Simms
Release 1 / Serial number 180924 / Inform 7 build 6M62 (I6/v6.33 lib 6/12N) SD

Floor 4s of Nugent Hall
It is a long hallway. The walls are red, and the carpet isn't very soft. To the NORTH lies the Elevators to leave, to the EAST lies Reagan's Room. To the WEST lies a large lounge.

>e
Reagan's Room
A girl with blue hair is sprawled on her bed, cursing at her laptop. A a blue-and-black mobility scooter is parked in the corner. She looks irritated at being interrupted. Better leave, then. There's a closed door near you. Perhaps it's a closet. 

The bookshelf sits off to the side in the room. On first glance, it seems nice enough. There's some leather bound books on the bottom shelf, and the rest of the shelves are filled with books from the library. It has been covered with marble contact paper, so it's a bit less plain. On top of it is a small glass with bamboo growing in it, and a succulent. Also, a purple beanie is haphazardly sitting on one of the shelves.

On the bookshelf is a purple beanie.

You can see a variety of plants on a variety of surfaces.

A wooden dresser, with a single open drawer, is pushed against the wall.

>examine closet
A surprisingly large closet, filled with clothes, right next to the door you entered through. You can probably ENTER it. There is a hidden object nearby, outside of the closet somewhere. What would you use to carry water in?

In the closet is Clothes.

>ENTER
You get into the closet.

In the closet you can see Clothes.

>examine closet
A surprisingly large closet, filled with clothes, right next to the door you entered through. You can probably ENTER it.

In the closet is Clothes.

>take bucket
That's hardly portable.

>examine bucket
You found a bucket. Hooray?

* * *

>examine closet
A surprisingly large closet, filled with clothes, right next to the door you entered through. You can probably ENTER it. There is a hidden object nearby, outside of the closet somewhere. What would you use to carry water in?

In the closet is Clothes.

>examine bucket
You found a bucket. Hooray?

>find bucket
That's not a verb I recognise.

>take bucket
You can't see any such thing.

* * *

>examine bucket
You found a bucket. Hooray?

>take gold star
You can't see any such thing.

>in bucket
I only understood you as far as wanting to (go) in.

>what is in bucket
That's not a verb I recognise.

>take bucket
That's hardly portable.

* * *

>examine plant
You see nothing special about Plant.

>examine bamboo
(Plant)
You see nothing special about Plant.

* * *

>examine plants
Upon further inspection, most of these are plastic.

>plants
That's not a verb I recognise.

>look at plants
Upon further inspection, most of these are plastic.

>take plants
Taken.

>inventory
You are carrying:
  Plants

>take succulent
(Plants)
You already have that.

>examine succulent
(Plants)
Upon further inspection, most of these are plastic.

* * *

>look closet
A surprisingly large closet, filled with clothes, right next to the door you entered through. You can probably ENTER it.

In the closet are Clothes and a Bucket.

>take clothes
That's fixed in place.

>take bucket
Taken.

* * *

>take dresser
That's fixed in place.

* * *

2.2
An Interactive Fiction by Reagan Simms
Release 1 / Serial number 180924 / Inform 7 build 6M62 (I6/v6.33 lib 6/12N) SD

Floor 4s of Nugent Hall
It is a long hallway. The walls are red, and the carpet isn't very soft. To the NORTH lies the Elevators to leave, to the EAST lies Reagan's Room. To the WEST lies a large lounge.

>examine carpet
Ouch, it's not very soft. Walking on hardwood floors would hurt less.

>east
Reagan's Room
A girl with blue hair is sprawled on her bed, cursing at her laptop. A a blue-and-black mobility scooter is parked in the corner. She looks irritated at being interrupted. Better leave, then.

The bookshelf sits off to the side in the room. On first glance, it seems nice enough. There's some leather bound books on the bottom shelf, and the rest of the shelves are filled with books from the library. It has been covered with marble contact paper, so it's a bit less plain. On top of it is a small glass with bamboo growing in it, and a succulent.

A wooden dresser, with a single open drawer, pushed against the wall.

* * *

2.2
An Interactive Fiction by Reagan Simms
Release 1 / Serial number 180924 / Inform 7 build 6M62 (I6/v6.33 lib 6/12N) SD

Floor 4s of Nugent Hall
It is a long hallway. The walls are red, and the carpet isn't very soft. To the NORTH lies the Elevators to leave, to the EAST lies Reagan's Room. To the WEST lies a large lounge.

>look
Floor 4s of Nugent Hall
This floor is a lively place. You can hear someone crying hystetically in their room. Oh dear. Midterms are coming, after all. I wonder why the paint is missing from the wall in front of Reagan's Room to the EAST. Someone exists the Elevators to the NORTH, and heads to the large lounge in the WEST.

>examine uncomfortable carpet
You see nothing special about Uncomfortable carpet.

* * *

>look
Floor 4s of Nugent Hall
This floor is a lively place. You can hear someone crying hystetically in their room. Oh dear. Midterms are coming, after all. I wonder why the paint is missing from the wall in front of Reagan's Room to the EAST. Someone exists the Elevators to the NORTH, and heads to the large lounge in the WEST.

>look uncomfortable carpet
You can't see any such thing.